5.83e+00,1.41e+00
5.08e+00,1.18e+00
4.83e+00,8.46e-01
4.59e+00,6.90e-01
4.42e+00,6.79e-01
4.40e+00,6.51e-01
4.24e+00,6.37e-01
4.14e+00,6.48e-01
4.14e+00,7.02e-01
4.01e+00,6.07e-01
4.37e+00,8.44e-01
4.08e+00,6.61e-01
3.83e+00,6.06e-01
3.71e+00,5.78e-01
3.59e+00,4.94e-01
3.49e+00,5.38e-01
3.38e+00,4.97e-01
3.26e+00,4.93e-01
3.24e+00,4.61e-01
3.11e+00,4.30e-01
4.24e+00,7.99e-01
3.99e+00,6.80e-01
3.74e+00,6.32e-01
3.65e+00,6.14e-01
3.51e+00,5.76e-01
3.35e+00,5.32e-01
3.27e+00,5.15e-01
3.16e+00,5.09e-01
3.10e+00,4.77e-01
3.05e+00,4.83e-01
3.23e+00,5.49e-01
3.11e+00,4.86e-01
2.97e+00,4.69e-01
2.92e+00,4.50e-01
2.88e+00,4.40e-01
2.80e+00,4.25e-01
2.65e+00,4.17e-01
2.65e+00,3.87e-01
2.59e+00,3.87e-01
2.55e+00,3.70e-01
3.37e+00,6.27e-01
3.13e+00,5.51e-01
3.06e+00,5.07e-01
2.86e+00,4.67e-01
2.82e+00,4.54e-01
2.73e+00,4.59e-01
2.64e+00,4.34e-01
2.62e+00,4.31e-01
2.63e+00,4.10e-01
2.54e+00,3.96e-01
2.74e+00,4.60e-01
2.56e+00,4.13e-01
2.49e+00,3.91e-01
2.49e+00,3.88e-01
2.35e+00,3.86e-01
2.34e+00,3.64e-01
2.30e+00,3.72e-01
2.24e+00,3.33e-01
2.24e+00,3.50e-01
2.19e+00,3.53e-01
2.85e+00,5.01e-01
2.62e+00,4.26e-01
2.57e+00,4.18e-01
2.48e+00,4.13e-01
2.39e+00,3.90e-01
2.36e+00,3.97e-01
2.30e+00,3.66e-01
2.25e+00,3.62e-01
2.21e+00,3.53e-01
2.18e+00,3.54e-01
2.36e+00,4.14e-01
2.26e+00,3.94e-01
2.18e+00,3.70e-01
2.16e+00,3.39e-01
2.11e+00,3.51e-01
2.08e+00,3.48e-01
2.06e+00,3.39e-01
2.05e+00,3.34e-01
2.03e+00,3.43e-01
2.04e+00,3.31e-01
2.18e+00,3.86e-01
2.09e+00,3.79e-01
2.04e+00,3.60e-01
1.99e+00,3.54e-01
1.99e+00,3.41e-01
1.97e+00,3.43e-01
1.94e+00,3.46e-01
1.94e+00,3.24e-01
1.93e+00,3.36e-01
1.91e+00,3.38e-01
2.32e+00,4.37e-01
2.12e+00,3.92e-01
2.09e+00,3.84e-01
2.01e+00,3.77e-01
1.99e+00,3.60e-01
1.97e+00,3.68e-01
1.98e+00,3.46e-01
1.91e+00,3.37e-01
1.90e+00,3.42e-01
1.91e+00,3.43e-01
2.08e+00,4.11e-01
2.00e+00,3.93e-01
1.93e+00,3.68e-01
1.88e+00,3.52e-01
1.86e+00,3.57e-01
1.87e+00,3.53e-01
1.87e+00,3.59e-01
1.85e+00,3.44e-01
1.83e+00,3.45e-01
1.84e+00,3.45e-01
1.95e+00,3.68e-01
1.88e+00,3.51e-01
1.86e+00,3.48e-01
1.86e+00,3.39e-01
1.81e+00,3.41e-01
1.81e+00,3.35e-01
1.77e+00,3.47e-01
1.80e+00,3.40e-01
1.79e+00,3.17e-01
1.80e+00,3.26e-01
1.90e+00,3.60e-01
1.87e+00,3.55e-01
1.82e+00,3.41e-01
1.81e+00,3.40e-01
1.82e+00,3.26e-01
1.79e+00,3.29e-01
1.78e+00,3.32e-01
1.76e+00,3.28e-01
1.75e+00,3.28e-01
1.76e+00,3.28e-01
2.04e+00,4.15e-01
1.92e+00,3.71e-01
1.86e+00,3.61e-01
1.84e+00,3.55e-01
1.82e+00,3.54e-01
1.81e+00,3.57e-01
1.81e+00,3.50e-01
1.78e+00,3.44e-01
1.78e+00,3.35e-01
1.76e+00,3.50e-01
1.88e+00,3.68e-01
1.82e+00,3.55e-01
1.80e+00,3.56e-01
1.77e+00,3.57e-01
1.75e+00,3.47e-01
1.76e+00,3.44e-01
1.75e+00,3.53e-01
1.74e+00,3.39e-01
1.74e+00,3.46e-01
1.73e+00,3.38e-01
1.98e+00,4.03e-01
1.88e+00,3.75e-01
1.82e+00,3.67e-01
1.79e+00,3.56e-01
1.78e+00,3.60e-01
1.77e+00,3.50e-01
1.74e+00,3.51e-01
1.76e+00,3.43e-01
1.73e+00,3.46e-01
1.76e+00,3.40e-01
1.84e+00,3.57e-01
1.78e+00,3.60e-01
1.77e+00,3.45e-01
1.75e+00,3.47e-01
1.73e+00,3.40e-01
1.73e+00,3.35e-01
1.74e+00,3.45e-01
1.73e+00,3.43e-01
1.73e+00,3.39e-01
1.70e+00,3.26e-01
1.80e+00,3.53e-01
1.75e+00,3.47e-01
1.74e+00,3.40e-01
1.73e+00,3.44e-01
1.73e+00,3.45e-01
1.73e+00,3.39e-01
1.70e+00,3.31e-01
1.71e+00,3.39e-01
1.70e+00,3.31e-01
1.70e+00,3.35e-01
1.80e+00,3.75e-01
1.76e+00,3.61e-01
1.74e+00,3.54e-01
1.71e+00,3.40e-01
1.70e+00,3.44e-01
1.68e+00,3.40e-01
1.68e+00,3.52e-01
1.68e+00,3.38e-01
