5.58e+00,9.13e-01
4.90e+00,6.33e-01
4.50e+00,5.80e-01
4.28e+00,5.23e-01
4.09e+00,5.11e-01
3.86e+00,4.07e-01
3.67e+00,3.98e-01
3.60e+00,3.65e-01
3.43e+00,3.59e-01
3.37e+00,3.31e-01
5.26e+00,8.70e-01
4.66e+00,7.05e-01
4.42e+00,5.93e-01
4.14e+00,5.19e-01
4.01e+00,5.05e-01
3.81e+00,4.92e-01
3.62e+00,4.13e-01
3.48e+00,3.82e-01
3.32e+00,3.40e-01
3.16e+00,3.12e-01
5.19e+00,9.22e-01
4.58e+00,7.06e-01
4.36e+00,6.28e-01
4.14e+00,5.59e-01
3.95e+00,4.92e-01
3.71e+00,4.51e-01
3.56e+00,4.22e-01
3.40e+00,3.88e-01
3.25e+00,4.12e-01
3.08e+00,3.83e-01
5.12e+00,8.46e-01
4.52e+00,6.55e-01
4.32e+00,5.68e-01
4.12e+00,4.96e-01
3.86e+00,4.55e-01
3.69e+00,4.31e-01
3.48e+00,4.37e-01
3.33e+00,4.26e-01
3.20e+00,3.45e-01
3.07e+00,3.21e-01
3.36e+00,4.47e-01
3.10e+00,3.79e-01
2.95e+00,3.43e-01
2.82e+00,3.16e-01
2.72e+00,2.78e-01
2.60e+00,2.86e-01
2.52e+00,2.68e-01
2.43e+00,2.85e-01
2.46e+00,2.56e-01
2.37e+00,2.45e-01
3.41e+00,5.16e-01
3.12e+00,4.33e-01
2.93e+00,3.90e-01
2.77e+00,3.57e-01
2.64e+00,3.39e-01
2.54e+00,3.23e-01
2.47e+00,3.01e-01
2.37e+00,3.03e-01
2.32e+00,2.73e-01
2.27e+00,3.04e-01
2.49e+00,3.84e-01
2.33e+00,3.20e-01
2.21e+00,2.83e-01
2.15e+00,2.85e-01
2.13e+00,2.78e-01
2.07e+00,2.50e-01
2.02e+00,2.54e-01
1.99e+00,2.52e-01
1.99e+00,2.55e-01
1.95e+00,2.35e-01
2.12e+00,3.34e-01
1.95e+00,2.72e-01
1.94e+00,2.59e-01
1.91e+00,2.68e-01
1.88e+00,2.54e-01
1.84e+00,2.31e-01
1.82e+00,2.31e-01
1.79e+00,2.33e-01
1.78e+00,2.24e-01
1.76e+00,2.34e-01
1.92e+00,3.13e-01
1.84e+00,2.76e-01
1.79e+00,2.62e-01
1.75e+00,2.67e-01
1.74e+00,2.57e-01
1.70e+00,2.49e-01
1.72e+00,2.49e-01
1.70e+00,2.49e-01
1.69e+00,2.26e-01
1.67e+00,2.37e-01
1.83e+00,2.81e-01
1.76e+00,2.56e-01
1.68e+00,2.46e-01
1.65e+00,2.48e-01
1.64e+00,2.55e-01
1.62e+00,2.40e-01
1.63e+00,2.32e-01
1.62e+00,2.19e-01
1.59e+00,2.28e-01
1.60e+00,2.32e-01
1.71e+00,2.60e-01
1.65e+00,2.38e-01
1.61e+00,2.44e-01
1.58e+00,2.28e-01
1.58e+00,2.19e-01
1.57e+00,2.39e-01
1.56e+00,2.54e-01
1.55e+00,2.33e-01
1.56e+00,2.33e-01
1.54e+00,2.28e-01
1.68e+00,2.73e-01
1.59e+00,2.41e-01
1.57e+00,2.29e-01
1.53e+00,2.38e-01
1.55e+00,2.23e-01
1.53e+00,2.33e-01
1.52e+00,2.18e-01
1.51e+00,2.21e-01
1.50e+00,2.23e-01
1.50e+00,2.18e-01
1.60e+00,2.62e-01
1.56e+00,2.36e-01
1.52e+00,2.28e-01
1.51e+00,2.37e-01
1.49e+00,2.21e-01
1.49e+00,2.28e-01
1.49e+00,2.22e-01
1.50e+00,2.20e-01
1.47e+00,2.07e-01
1.48e+00,2.23e-01
1.58e+00,2.43e-01
1.54e+00,2.28e-01
1.49e+00,2.18e-01
1.46e+00,2.15e-01
1.47e+00,2.09e-01
1.46e+00,2.15e-01
1.46e+00,2.21e-01
1.47e+00,2.11e-01
1.45e+00,2.11e-01
1.46e+00,2.05e-01
1.53e+00,2.51e-01
1.48e+00,2.27e-01
1.48e+00,2.21e-01
1.44e+00,2.14e-01
1.45e+00,2.08e-01
1.43e+00,2.10e-01
1.43e+00,2.07e-01
1.43e+00,2.10e-01
1.43e+00,2.08e-01
1.42e+00,2.08e-01
1.64e+00,2.78e-01
1.52e+00,2.46e-01
1.48e+00,2.23e-01
1.44e+00,2.24e-01
1.44e+00,2.24e-01
1.43e+00,2.19e-01
1.43e+00,2.15e-01
1.41e+00,2.12e-01
1.42e+00,2.13e-01
1.40e+00,2.09e-01
1.69e+00,3.19e-01
1.57e+00,2.67e-01
1.49e+00,2.49e-01
1.46e+00,2.40e-01
1.44e+00,2.24e-01
1.43e+00,2.31e-01
1.41e+00,2.20e-01
1.41e+00,2.24e-01
1.41e+00,2.20e-01
1.41e+00,2.25e-01
1.50e+00,2.50e-01
1.44e+00,2.41e-01
1.41e+00,2.32e-01
1.40e+00,2.27e-01
1.42e+00,2.26e-01
1.38e+00,2.23e-01
1.38e+00,2.18e-01
1.37e+00,2.19e-01
1.37e+00,2.22e-01
